0,1,2,3,4,5,6,7,8,9
X,X,X,X,X,X,G,X,X,X
X,X,X,X,G,G,G,G,X,X
X,X,X,G,G,G,G,G,G,G
X,X,X,G,a,W,W,W,W,G
X,X,G,G,G,W,W,W,W,W
X,G,G,G,W,W,W,W,W,G
X,G,G,G,G,W,W,G,G,G
G,G,G,G,G,G,W,W,b,G
G,G,G,G,G,G,G,W,G,G
G,G,G,G,G,G,G,G,G,G